
1 1 1 1 1 1 1 1 1 1 1 1 1 1 1 1 1 1 1 1 1 1 1 1
1 0 0 0 0 0 0 0 0 0 0 0 0 0 0 0 7 0 0 0 0 0 0 1
1 0 1 0 0 0 0 0 0 0 0 0 0 0 0 0 0 0 0 0 0 0 0 1
1 0 2 0 0 0 0 0 0 0 0 0 0 0 0 0 0 0 0 0 0 0 0 1
1 0 3 0 0 0 0 0 0 0 0 0 0 0 0 0 7 0 0 0 0 0 0 1
1 0 4 0 0 0 0 5 5 5 5 5 5 5 5 5 7 7 0 7 7 7 7 1
1 0 5 0 0 0 0 5 0 5 0 5 0 5 0 5 7 0 0 0 7 7 7 1
1 0 3 0 0 0 0 5 0 0 0 0 0 0 0 5 7 0 0 0 0 0 0 1
1 0 7 0 0 0 0 0 0 0 0 0 0 0 0 0 0 0 0 0 7 7 7 1
1 0 8 0 0 0 0 5 0 0 0 0 0 0 0 5 7 0 0 0 0 0 0 1
1 0 0 0 0 0 0 5 0 0 0 0 0 0 0 5 7 0 0 0 7 7 7 1
1 0 0 0 0 0 0 5 5 5 5 0 5 5 5 5 7 7 7 7 7 7 7 1
1 6 6 6 6 6 6 6 6 6 6 0 6 6 6 6 6 6 6 6 6 6 6 1
1 0 0 0 0 0 0 0 0 0 0 0 0 0 0 0 0 0 0 0 0 0 0 1
1 6 6 6 6 6 0 6 6 6 6 0 6 6 6 6 6 6 6 6 6 6 6 1
1 4 4 4 4 4 0 4 4 4 6 0 6 2 2 2 2 2 2 2 3 3 3 1
1 0 0 0 0 0 0 0 0 4 6 0 6 2 0 0 0 0 0 2 0 0 0 1
1 0 0 0 0 0 0 0 0 0 0 0 6 2 0 0 5 0 0 2 0 0 0 1
1 0 0 0 0 0 0 0 0 4 6 0 6 2 0 0 0 0 0 2 2 0 2 1
1 0 6 0 6 0 0 0 0 4 6 0 0 0 0 0 5 0 0 0 0 0 0 1
1 0 0 5 0 0 0 0 0 4 6 0 6 2 0 0 0 0 0 2 2 0 2 1
1 0 6 0 6 0 0 0 0 4 6 0 6 2 0 0 5 0 0 2 0 0 0 1
1 0 0 0 0 0 0 0 0 4 6 0 6 2 0 0 0 0 0 2 0 0 0 1
1 1 1 1 1 1 1 1 1 1 1 0 1 1 1 1 1 1 1 1 1 1 1 1
