1 1 1 0 1 1 1 1 1 1 1 1 1 1 1 1 1 1 1 1 1 1 1 1
1 0 0 P 0 0 0 0 0 0 0 0 0 0 0 0 7 0 0 0 0 0 0 1
1 0 4 0 0 0 0 0 0 2 2 2 2 2 2 0 0 0 0 0 0 0 0 1
1 0 0 0 0 0 0 0 0 0 0 0 0 0 0 0 0 0 0 0 0 0 0 1
0 0 4 0 0 0 0 0 0 0 0 0 0 0 0 0 7 0 0 0 0 0 0 1
1 0 0 0 0 0 0 5 5 5 5 5 5 5 5 5 7 7 0 7 7 7 7 1
1 0 4 0 0 0 0 5 0 5 0 5 0 5 0 5 7 0 0 0 7 7 7 1
1 0 0 0 0 0 0 5 0 0 0 0 0 0 0 5 7 0 0 0 0 0 0 1
1 0 4 0 0 0 0 0 0 0 0 0 0 0 0 0 0 0 0 0 7 7 7 1
1 0 0 0 0 0 0 5 0 0 0 0 0 0 0 5 7 0 0 0 0 0 0 1
1 0 0 0 0 0 0 5 0 0 0 0 0 0 0 5 7 0 0 0 7 7 7 1
0 0 0 0 0 0 0 5 5 5 5 0 5 5 5 5 7 7 7 7 7 7 7 1
1 0 6 6 6 6 6 6 6 6 6 0 6 6 6 6 6 6 6 6 6 6 0 1
1 0 6 0 6 0 0 0 0 4 6 0 6 2 0 0 5 0 0 2 0 0 0 1
1 0 0 0 0 0 0 0 0 4 6 0 6 2 0 0 0 0 0 2 0 0 0 1
1 0 0 0 0 0 0 0 0 0 0 0 0 0 0 0 0 0 0 0 0 0 0 1
1 0 0 0 0 0 0 0 0 0 0 0 0 0 0 0 0 0 0 0 0 0 0 1
1 1 1 1 1 1 1 1 1 1 1 1 1 1 1 1 1 1 1 1 1 1 1 1